40 80
22222222222222222222210000000000000000000000000000000000000000000000000000000000
22222222222222222222210000000000000000000000000000000000000000000000000000000000
22222222222222222222210000000000000000000000000000000000000000000000000000000000
22222222222222222222210000000000000000000000000000000000000000000000000000000000
22222222222222222222210000000000000000000000000000000000000000000000000000000000
22222222222222222222210000000000000000000000000000000000000000000000000000000000
22222222222222222222210000000000000000000000000000000000000000000000000000000000
22222222222222222222210000000000000000000000000000001000222222222222220000000000
22222222222222222222210000000000000000000000000000001000222222222222220000000000
22222222222222222222210000000000000000000000000000001000222222222222220000000000
22222222222222222222210001111000000000000000000000001000222222222222220000000000
22222222222222222222210001111000000000000000000000001010222222222222220100000000
22222222222222222222210001111000000000000000000000001010222222222222220100000000
22222222222222222222210001111000000000000000000000001010222222222222220100000000
22222222222222222222210001111000000000000000000000001010222222222222220100000010
22222222222222222222210001111000000000000000000000001010000000000000000100000010
00000000000000000000010001111000000000000000000000001011111111101111111100000010
11110000000000000000010001111000000000000000000000001000000000000000000000000010
11110000000000000000010001111000000000000000000000001111111111111111111111111010
11111111100000000000010001111000000000000000000000000000000000000000000000000000
11111111100000000000010001111000000000000000000000000000000000000000000000000000
11111111100000000000010001111000000000000000000000000000000000000000000000000000
11111111111111100000010001111000000000000000000000000000000000000000000000000000
11111111111111100000010101111000000000000000000000000000000000000000000000000000
11111111111111100000010101111000000000000000000000000000000000000000000000000000
11111111111111111111010101111000000000000000000000000000000000000000000000000000
11111111111111111111010101111000000000000000000000000000000000000000000000000000
11111111111111111111010101111000000000000000000000000000000000000000000000000000
11111111111111111111010101111000000000000000000000000000000000000000000000000000
11111111111111111111010101111000000000000000000000000000000000000000000000000000
11111111111111111111010101111000000000000000000000000000000000000000000000000000
11111111111111111111010101111000000000000000000000000000000000000000000000000000
11111111111111111111010101111000000000000000000000000000000000000000000000000000
11111111111111111111010101111000000000000000000000000000000000000000000000000000
11111111111111111111010101111000000000000000000000000000000000000000000000000000
11111111111111111111010101111000000000000000000000000000000000000000000000000000
11111111111111111111010101111000000000000000000000000000000000000000000000000000
11111111111111111111000101111000000000000000000000000000000000000000000000000000
11111111111111111111000101111000000000000000000000000000000000000000000000000000
11111111111111111111000100000000000000000000000000000000000000000000000000000000
