42 80
00000000000000000000000000000000000000000000000000000000000000000000000000000000
00000000000000000000000000000000000000000000000000000000001222222222222222222222
00000000000000000000000000000000000000000000000000000000001222222222222222222222
00000000000000000000000000000000000000000000000000000000001222222222222222222222
00000000000000000000000000000000000000000000000000000000001222222222222222222222
00000000000000000000000000000000000000000000000000000000001222222222222222222222
00000000000000000000000000000000000000000000000000000000001222222222222222222222
00000000000000000000000000000000000000000000000000000000001222222222222222222222
00000000002222222222222200010000000000000000000000000000001222222222222222222222
00000000002222222222222200010000000000000000000000000000001222222222222222222222
00000000002222222222222200010000000000000000000000000000001222222222222222222222
00000000002222222222222200010000000000000000000000011110001222222222222222222222
00000000102222222222222201010000000000000000000000011110001222222222222222222222
00000000102222222222222201010000000000000000000000011110001222222222222222222222
00000000102222222222222201010000000000000000000000011110001222222222222222222222
01000000102222222222222201010000000000000000000000011110001222222222222222222222
01000000100000000000000001010000000000000000000000011110001222222222222222222222
01000000111111110111111111010000000000000000000000011110001000000000000000000000
01000000000000000000000000010000000000000000000000011110001000000000000000001111
01011111111111111111111111110000000000000000000000011110001000000000000000001111
01100000000000000000000000000000000000000000000000011110001000000000000111111111
11000000000000000000000000000000000000000000000000011110001000000000000111111111
00000000000000000000000000000000000000000000000000011110001000000000000111111111
00000000000000000000000000000000000000000000000000011110001000000111111111111111
00000000000000000000000000000000000000000000000000011110101000000111111111111111
00000000000000000000000000000000000000000000000000011110101000000111111111111111
00000000000000000000000000000000000000000000000000011110101011111111111111111111
00000000000000000000000000000000000000000000000000011110101011111111111111111111
00000000000000000000000000000000000000000000000000011110101011111111111111111111
00000000000000000000000000000000000000000000000000011110101011111111111111111111
00000000000000000000000000000000000000000000000000011110101011111111111111111111
00000000000000000000000000000000000000000000000000011110101011111111111111111111
00000000000000000000000000000000000000000000000000011110101011111111111111111111
00000000000000000000000000000000000000000000000000011110101011111111111111111111
00000000000000000000000000000000000000000000000000011110101011111111111111111111
00000000000000000000000000000000000000000000000000011110101011111111111111111111
00000000000000000000000000000000000000000000000000011110101011111111111111111111
00000000000000000000000000000000000000000000000000011110101011111111111111111111
00000000000000000000000000000000000000000000000000000000100011111111111111111111
00000000000000000000000000000000000000000000000000000000100011111111111111111111
00000000000000000000000000000000000000000000000000000000100011111111111111111111
11111111111111111111111111111111111111111111111111111111111111111111111111111111
