42 80
00000000000000000000000011111111111111000000000000000000000000000000000000000000
22222222222222222222222211111111111111000110100000000000000000000000000000000000
22222222222222222222222211111111111111000110100000000000000000000000000000000000
22222222222222222222222211111111111111000110100000000000000000000000000000000000
22222222222222222222222211111111111111000110100000000000000000000000000000000000
22222222222222222222222211111111111111000110100000000000000000000000000000000000
22222222222222222222222211111111111111000110100000000000000000000000000000000000
22222222222222222222222211111111111111000110100000000000000000000000000000000000
22222222222222222222222211111111111111000110100000000000000000000000000000000000
22222222222222222222222211111111111111000110100000000000000000000000000000000000
22222222222222222222222211111111111111000110100000000000000000000000000000000000
22222222222222222222222211111111111111000110100000000000000000000000000000000000
22222222222222222222222211111111111111000110100000000000000000000000000000000000
22222222222222222222222211111111111111000110100000000000000000000000000000000000
22222222222222222222222211111111111111000110100000000000000000000000000000000000
22222222222222222222222211111111111111000110100000000000000000000000000000000000
22222222222222222222222211111111111111000110100000000000000000000000000000000000
22222222222222222222222211111111111111000110100000000000000000000000000000000000
22222222222222222222222211111111111111000110100000000000000000000000000000000000
22222222222222222222222211111111111111000000100000000000000000000000000000000000
22222222222222222222222211111111111111000000100000000000000000000000000000000000
22222222222222222222222211111111111111000000100000000000000000000000000000000000
22222222222222222222222211111111111111000000100000000000000000000000000000000000
22222222222222222222222211111111111111000000100000000000000000000000000000000000
22222222222222222222222211111111111111000000100000000000000000000000000000000000
22222222222222222222222211111111111111000000100000000000000000000000000000000000
22222222222222222222222211111111111111000000100000000000000000000000000000000000
22222222222222222222222211111111111111000000100000000000000000000000000000000000
22222222222222222222222211111111111111000000100000000000000000000000000000000000
22222222222222222222222211111111111111000000100000000000000000000000000000000000
22222222222222222222222211111111111111000000100000000000000000000000000000000000
22222222222222222222222211111111111111000000100000000000000000000000000000000000
22222222222222222222222211111111111111000000100000000000000000000000000000000000
22222222222222222222222211111111111111000000100000000000000000000000000000000000
22222222222222222222222211111111111111000000100000000000000000000000000000000000
22222222222222222222222211111111111111000110100000000000000000000000000000000000
22222222222222222222222211111111111111000110100000000000000000000000000000000000
00000000000000000000000011111111111111000110100000000000000000000000000000000000
00000000000000000000000000000000000000000110100000000000000000000000000000000000
00000000000000000000000000000000000000000110100000000000000000000000000000000000
00000000000000000000000000000000000000000110100000000000000000000000000000000000
00000000000000000000000000000000000000000110000000000000000000000000000000000000
