42 80
00000000000000000000000011111111111111000000000000000000000000000000000000000000
22222222222222222222222211111111111111000000102222222222222222222222222222222220
22222222222222222222222211111111111111000000102222222222222222222222222222222220
22222222222222222222222211111111111111000000102222222222222222222222222222222220
22222222222222222222222211111111111111000000102222222222222222222222222222222220
22222222222222222222222211111111111111000000102222222222222222222222222222222220
22222222222222222222222211111111111111000000102222222222222000000000000000000000
22222222222222222222222211111111111111000000102222222222222011111111111111111111
22222222222222222222222211111111111111000000102222222222222010000000000000000000
22222222222222222222222211111111111111000000102222222222222010000000000000000000
22222222222222222222222211111111111111000000102222222222222010000000000000000000
22222222222222222222222211111111111111000000102222222222222010000000000000000000
22222222222222222222222211111111111111000000102222222222222010000000000000000000
22222222222222222222222211111111111111000000102222222222222010000000000000000000
22222222222222222222222211111111111111000000102222222222222011111111111111111111
22222222222222222222222211111111111111000000102222222222222010000000000000000000
22222222222222222222222211111111111111000000102222222222222010000000000000000000
22222222222222222222222211111111111111000000100000000000000010000000000000000000
22222222222222222222222211111111111111000000111111110111111110000000000000000000
22222222222222222222222211111111111111000000100000000000000000000000000000000000
22222222222222222222222211111111111111000000100000000000000000000000000000000000
22222222222222222222222211111111111111000000111111111111111111111111111111111111
22222222222222222222222211111111111111000000100000000000000000000000000000000000
22222222222222222222222211111111111111000000100000000000000000000000000000000000
22222222222222222222222211111111111111000000100000000000000000000000000000000000
22222222222222222222222211111111111111000000100000000000000000000000000000000000
22222222222222222222222211111111111111000000100000000000000000000000000000000000
22222222222222222222222211111111111111000000100000000000000000000000000000000000
22222222222222222222222211111111111111000000100000000000000000000000000000000000
22222222222222222222222211111111111111000000100000000000000000000000000000000000
22222222222222222222222211111111111111000000100000000000000000000000000000000000
22222222222222222222222211111111111111000000100000000000000000000000000000000000
22222222222222222222222211111111111111000000100000000000000000000000000000000000
22222222222222222222222211111111111111000000100000000000000000000000000000000000
22222222222222222222222211111111111111000000100000000000000000000000000000000000
22222222222222222222222211111111111111000110100000000000000000000000000000000000
22222222222222222222222211111111111111000110100000000000000000000000000000000000
00000000000000000000000011111111111111000110100000000000000000000000000000000000
00000000000000000000000000000000000000000110100000000000000000000000000000000000
00000000000000000000000000000000000000000110100000000000000000000000000000000000
00000000000000000000000000000000000000000110100000000000000000000000000000000000
00000000000000000000000000000000000000000110000000000000000000000000000000000000
