42 80
00000000000000000000000000000000000000000000000000000000000000000000000000000000
22222222222222222222210000000000000000000000000000000000000000000000000000000000
22222222222222222222210000000000000000000000000000000000000000000000000000000000
22222222222222222222210000000000000000000000000000000000000000000000000000000000
22222222222222222222210000000000000000000000000000000000000000000000000000000000
22222222222222222222210000000000000000000000000000000000000000000000000000000000
22222222222222222222210000000000000000000000000000000000000000000000000000000000
22222222222222222222210000000000000000000000000000000000000000000000000000000000
22222222222222222222210000000000000000000000000000000000222222222222220000000000
22222222222222222222210000000000000000000000000000000000222222222222220000000000
22222222222222222222210000000000000000000000000000000000222222222222220000000000
22222222222222222222210001111000000000000000000000000000222222222222220000000000
22222222222222222222210001111000000000000000000000000000222222222222220000000000
22222222222222222222210001111000000000000000000000000000222222222222220000000000
22222222222222222222210001111000000000000000000000000000222222222222220000000000
22222222222222222222210001111000000000000000000000000000222222222222220000000000
22222222222222222222210001111000000000000000000000000000000000000000000000000000
00000000000000000000010001111000000000000000000000000000000000000000000000000000
11111111111111111111010001111000000000000000000000000000000000000000000000000000
11111111111111111111010001111000000000000000000000000000000000000000000000000000
11111111111111111111010001111000000000000000000000000000000000000000000000000000
11111111111111111111010001111000000000000000000000000000000000000000000000000000
11111111111111111111010001111000000000000000000000000000000000000000000000000000
11111111111111111111010001111000000000000000000000000000000000000000000000000000
11111111111111111111010001111000000000000000000000000000000000000000000000000000
11111111111111111111010001111000000000000000000000000000000000000000000000000000
11111111111111111111010001111000000000000000000000000000000000000000000000000000
11111111111111111111010001111000000000000000000000000000000000000000000000000000
11111111111111111111010001111000000000000000000000000000000000000000000000000000
11111111111111111111010001111000000000000000000000000000000000000000000000000000
11111111111111111111010001111000000000000000000000000000000000000000000000000000
11111111111111111111010001111000000000000000000000000000000000000000000000000000
11111111111111111111010001111000000000000000000000000000000000000000000000000000
11111111111111111111010001111000000000000000000000000000000000000000000000000000
11111111111111111111010001111000000000000000000000000000000000000000000000000000
11111111111111111111010001111000000000000000000000000000000000000000000000000000
11111111111111111111010000000000000000000000000000000000000000000000000000000000
11111111111111111111010000000000000000000000000000000000000000000000000000000000
11111111111111111111000000000000000000000000000000000000000000000000000000000000
11111111111111111111000000000000000000000000000000000000000000000000000000000000
11111111111111111111000000000000000000000000000000000000000000000000000000000000
11111111111111111111111111111111111111111111111111111111111111111111111111111111
