42 80
22222222222222222222222222222222221100000000000000000000000000000000000000000000
22222222222222222222222222222222221100000000000000000000000000000000000000000000
22222222222222222222222222222222221100000000000000000000000000000000000000000000
22222222222222222222222222222222221100000000000000000000000000000000000000000000
22222222222222222222222222222222221100000000000000000000000000000000000000000000
22222222222222222222222222222222221100000000000000000000000000000000000000000000
22222222222222222222222222222222221100000000000000000000000000000000000000000000
22222222222222222222222222222222221100000000000000000000000000000000000000000000
22222222222222222222222222222222221100000000000000000000000000000000000000000000
22222222222222222222222222222222221100000000000000000000000000000000000000000000
22222222222222222222222222222222221100000000000000000000000000000000000000000000
22222222222222222222222222222222221100000000000000000000000000000000000000000000
22222222222222222222222222222222221100000000000000000000000000000000000000000000
22222222222222222222222222222222221100000000000000000000000000000000000000000000
22222222222222222222222222222222221100000000000000000000000000000000000000000000
22222222222222222222222222222222221100000000000000000000000000000000000000000000
22222222222222222222222222222222221100000000000000000000000000000000000000000000
22222222222222222222222222222222221100000000000000000000000000000000000000000000
22222222222222222222222222222222221100000000000000000000000000000000000000000000
22222222222222222222222222222222221100000000000000000000000000000000000000000000
22222222222222222222222222222222221100000000000000000000000000000000000000000000
22222222222222222222222222222222221100000000000000000000000000000000000000000000
22222222222222222222222222222222221100000000000000000000000000000000000000000000
22222222222222222222222222222222221100000000000000000000000000000000000000000000
22222222222222222222222222222222221100000000000000000000000000000000000000000000
22222222222222222222222222222222221100000000000000000000000000000000000000000000
22222222222222222222222222222222221100000000000000000000000000000000000000000000
22222222222222222222222222222222221100000000000000000000000000000000000000000000
22222222222222222222222222222222221100000000000000000000000000000000000000000000
00000000000000000000000000000000001100000000000000000000000000000000000000000000
00000000000000000000000000000000001100000000000000000000000000000000000000000000
00000000000000000000000000000000001100000000000000000000000000000000000000000000
00000000000000000000000000000000001100000000000000000000000000000000000000000000
00000000000000000000000000000000001100000000000000000000000000000000000000000000
00000000000000000000000000000000001100000000000000000000000000000000000000000000
00000000000000000000000000000000001100000000000000000000000000000000000000000000
00000000000000000000000000000000001100000000000011111111111111111111111111111111
00000000000000000000000000000000001100000000000011111111111111111111111111111111
00000000000000000000000000000000000000000000000011111111111111111111111111111111
00000000000000000000000000000000000000000000000011111111111111111111111111111111
00000000000000000000000000000000000000000000000011111111111111111111111111111111
00000000000000000000000000000000000000000000000011111111111111111111111111111111
